12 20 160
                   #
#+**               #
#####H   H***+**   #
#    H   H#######H #
#%   H   H       H  
#    H***H       H #
#    ####H     % H #
#        H       H #
#        H-------H**
#        H#     ####
#@  **** H ****+   #
####################