12 11 120
           
H +       %
H##   **   
H    H#####
H    H     
H    H***  
H H########
H H****    
H #####H   
H      H   
H@ **+*H   
###########